chlorophyll_RFU,depth_m,doSaturation_percent,doConcentration_mgpL,orp_mV,waterPressure_barA,salinity_psu,specificConductivity_uSpcm,phycocyaninBGA_RFU,tds_mgpL,turbidity_FNU,pH,temp_degC,verticalPosition_m,latitude,longitude,altitude_m,barometerAirHandheld_mbars,date,dateTime,MULakeNumber
1.06,0.163,107,8.07,171.2,0.016,0.14,307.5,0.75,200,5.97,8.19,30.071,0.163,39.76281,-94.25844,286,978.9,2020-07-13,2020-07-13T12:50:07Z,211
1.2,0.218,112.2,8.45,168.5,0.021,0.14,308,0.87,200,6.09,8.29,30.118,0.236,39.76281,-94.25846,286.2,978.9,2020-07-13,2020-07-13T12:50:19Z,211
1.15,0.289,112.1,8.45,168.4,0.028,0.14,308.2,0.81,200,6.03,8.29,30.112,0.331,39.76281,-94.25847,286.2,978.9,2020-07-13,2020-07-13T12:50:20Z,211
1.18,0.403,112.4,8.47,168,0.039,0.14,308.2,0.9,200,6.05,8.3,30.089,0.459,39.76281,-94.25847,286.3,978.7,2020-07-13,2020-07-13T12:50:21Z,211
1.23,0.513,112.6,8.49,167.6,0.05,0.14,308.1,0.96,200,5.83,8.3,30.089,0.531,39.76281,-94.25848,286.4,978.8,2020-07-13,2020-07-13T12:50:22Z,211
1.28,0.568,112.7,8.5,167.2,0.055,0.14,308.2,0.96,200,5.82,8.31,30.093,0.59,39.76281,-94.25848,286.4,978.8,2020-07-13,2020-07-13T12:50:23Z,211
1.31,0.64,112.8,8.51,166.9,0.062,0.14,308.1,1,200,6.24,8.31,30.097,0.651,39.76281,-94.25848,286.5,978.8,2020-07-13,2020-07-13T12:50:24Z,211
1.35,0.681,112.9,8.51,166.7,0.067,0.14,308.1,0.97,200,6.16,8.31,30.097,0.693,39.76281,-94.25849,286.6,978.9,2020-07-13,2020-07-13T12:50:25Z,211
1.33,0.723,113,8.52,166.6,0.071,0.14,308.1,1.01,200,6.01,8.31,30.099,0.741,39.76281,-94.25849,286.5,978.9,2020-07-13,2020-07-13T12:50:26Z,211
1.33,0.769,113,8.52,166.4,0.075,0.14,308.2,1.06,200,5.96,8.32,30.097,0.799,39.76281,-94.25849,286.5,979,2020-07-13,2020-07-13T12:50:27Z,211
1.39,0.861,113.1,8.53,166.2,0.084,0.14,308.2,1.06,200,6.03,8.32,30.087,0.871,39.76281,-94.25849,286.6,978.9,2020-07-13,2020-07-13T12:50:28Z,211
1.38,0.905,113.4,8.56,165.9,0.088,0.14,308.1,1.03,200,5.7,8.33,30.072,0.927,39.76281,-94.25849,286.6,979,2020-07-13,2020-07-13T12:50:30Z,211
1.35,0.947,113.5,8.56,165.7,0.092,0.14,308.1,1.01,200,5.83,8.33,30.056,0.953,39.76281,-94.25849,286.6,978.8,2020-07-13,2020-07-13T12:50:31Z,211
1.38,1.024,113.5,8.57,165.6,0.1,0.14,308.1,1.05,200,5.83,8.33,30.051,1.061,39.76281,-94.25849,286.6,978.9,2020-07-13,2020-07-13T12:50:32Z,211
1.39,1.111,113.6,8.57,165.5,0.108,0.14,308.1,1.1,200,5.74,8.34,30.055,1.129,39.76281,-94.25849,286.8,978.8,2020-07-13,2020-07-13T12:50:33Z,211
1.43,1.153,113.6,8.58,165.4,0.113,0.14,308.1,1.03,200,5.61,8.34,30.048,1.155,39.76281,-94.25849,287,978.9,2020-07-13,2020-07-13T12:50:34Z,211
1.42,1.172,113.7,8.58,165.2,0.114,0.14,308.1,1.03,200,5.59,8.34,30.036,1.184,39.76281,-94.25848,287.1,978.9,2020-07-13,2020-07-13T12:50:35Z,211
1.38,1.21,113.6,8.58,165,0.118,0.14,308.1,1.05,200,5.53,8.34,30.022,1.221,39.76281,-94.25848,287.3,978.9,2020-07-13,2020-07-13T12:50:36Z,211
1.4,1.244,113.5,8.57,164.9,0.121,0.14,308.1,1,200,5.47,8.34,30.011,1.256,39.76281,-94.25848,287.4,978.8,2020-07-13,2020-07-13T12:50:37Z,211
1.41,1.275,113.6,8.58,164.8,0.125,0.14,308.1,1,200,5.63,8.35,30.006,1.318,39.76281,-94.25848,287.5,978.7,2020-07-13,2020-07-13T12:50:38Z,211
1.41,1.371,113.6,8.58,164.6,0.134,0.14,308,1.04,200,5.75,8.35,29.99,1.395,39.76281,-94.25848,287.5,978.9,2020-07-13,2020-07-13T12:50:39Z,211
1.42,1.44,113.6,8.58,164.5,0.141,0.14,308.1,1.11,200,5.62,8.35,29.976,1.455,39.76281,-94.25848,287.6,978.8,2020-07-13,2020-07-13T12:50:40Z,211
1.41,1.48,113.6,8.58,164.5,0.145,0.14,308,1.08,200,5.58,8.35,29.973,1.504,39.76281,-94.25848,287.7,978.9,2020-07-13,2020-07-13T12:50:41Z,211
1.43,1.561,113.6,8.59,164.2,0.152,0.14,307.9,1.06,200,5.82,8.35,29.98,1.607,39.76281,-94.25848,287.8,979,2020-07-13,2020-07-13T12:50:43Z,211
1.43,1.654,113.6,8.58,164.1,0.161,0.14,307.9,1.02,200,5.78,8.35,29.976,1.682,39.76281,-94.25848,287.9,979,2020-07-13,2020-07-13T12:50:44Z,211
1.46,1.736,113.5,8.58,164.1,0.17,0.14,308,1.04,200,5.65,8.35,29.959,1.749,39.76281,-94.25848,287.9,978.8,2020-07-13,2020-07-13T12:50:45Z,211
1.45,1.775,113.6,8.59,164,0.173,0.14,308,1.07,200,5.7,8.35,29.959,1.782,39.76281,-94.25848,287.9,979,2020-07-13,2020-07-13T12:50:46Z,211
1.43,1.817,113.5,8.58,163.9,0.177,0.14,308,1.09,200,5.75,8.35,29.959,1.839,39.76281,-94.25848,287.8,978.9,2020-07-13,2020-07-13T12:50:47Z,211
1.46,1.892,113.5,8.58,163.8,0.185,0.14,307.9,1.11,200,5.88,8.35,29.956,1.927,39.76281,-94.25848,287.9,978.8,2020-07-13,2020-07-13T12:50:48Z,211
1.49,1.979,113.4,8.57,163.7,0.193,0.14,307.9,1.04,200,6.04,8.36,29.95,1.996,39.76281,-94.25848,288,978.9,2020-07-13,2020-07-13T12:50:49Z,211
1.5,2.023,113.3,8.57,163.6,0.198,0.14,308,1.03,200,5.88,8.35,29.939,2.037,39.76281,-94.25848,288,978.8,2020-07-13,2020-07-13T12:50:50Z,211
1.45,2.061,113.3,8.57,163.6,0.201,0.14,308,1.06,200,6.12,8.36,29.933,2.098,39.76281,-94.25848,288.2,978.9,2020-07-13,2020-07-13T12:50:51Z,211
1.45,2.138,113.2,8.56,163.5,0.209,0.14,308,1.05,200,6.19,8.36,29.93,2.155,39.76281,-94.25848,288.3,978.8,2020-07-13,2020-07-13T12:50:52Z,211
1.57,2.207,113.1,8.55,163.5,0.216,0.14,308,1.04,200,6.12,8.36,29.916,2.236,39.76281,-94.25848,288.5,979,2020-07-13,2020-07-13T12:50:53Z,211
1.61,2.286,112.6,8.52,163.4,0.223,0.14,308.2,1.09,200,6.17,8.35,29.837,2.32,39.76281,-94.25848,288.4,979,2020-07-13,2020-07-13T12:50:54Z,211
1.56,2.375,111.9,8.49,163.3,0.232,0.15,308.7,1.13,201,6.2,8.35,29.684,2.396,39.76281,-94.25848,288.5,978.9,2020-07-13,2020-07-13T12:50:55Z,211
1.61,2.435,111.3,8.47,163.4,0.238,0.15,308.8,1.11,201,6.17,8.34,29.554,2.45,39.76281,-94.25848,288.5,978.9,2020-07-13,2020-07-13T12:50:56Z,211
1.68,2.477,110.7,8.43,163.6,0.242,0.14,308.4,1.12,200,6.79,8.34,29.542,2.5,39.76281,-94.25848,288.5,978.9,2020-07-13,2020-07-13T12:50:57Z,211
1.75,2.555,109.8,8.36,163.6,0.249,0.14,308.3,1.18,200,8.01,8.33,29.495,2.607,39.76281,-94.25848,288.5,978.8,2020-07-13,2020-07-13T12:50:58Z,211
1.92,2.654,108.1,8.24,163.8,0.259,0.15,308.8,1.9,201,9.98,8.3,29.323,2.663,39.76281,-94.25848,288.6,978.9,2020-07-13,2020-07-13T12:50:59Z,211
2.05,2.697,99.2,7.6,164.1,0.263,0.15,311.1,3.07,202,11.91,8.25,28.739,2.705,39.76281,-94.25848,288.6,978.9,2020-07-13,2020-07-13T12:51:00Z,211
2.12,2.73,91.2,7.07,164.4,0.267,0.15,315.1,3.56,205,12.56,8.22,28.069,2.761,39.76281,-94.25848,288.6,978.9,2020-07-13,2020-07-13T12:51:01Z,211
2.16,2.786,81.7,6.42,165.5,0.272,0.15,317.5,3.63,206,13.04,8.14,27.453,2.794,39.76281,-94.25848,288.4,978.9,2020-07-13,2020-07-13T12:51:02Z,211
2.25,2.83,68.9,5.47,165.8,0.277,0.15,320.5,3.67,208,13.09,8.06,26.927,2.856,39.76281,-94.25848,288.4,978.8,2020-07-13,2020-07-13T12:51:03Z,211
2.39,2.892,58.9,4.73,166.2,0.283,0.15,323.9,3.37,211,12.41,7.99,26.071,2.913,39.76281,-94.25848,288.4,978.8,2020-07-13,2020-07-13T12:51:04Z,211
2.61,2.942,48.5,3.95,166.3,0.288,0.15,326.3,3.15,212,12.36,7.92,25.663,2.966,39.76281,-94.25848,288.4,978.9,2020-07-13,2020-07-13T12:51:05Z,211
2.62,3.005,44,3.59,166.3,0.294,0.16,327.6,2.9,213,13.48,7.87,25.38,3.033,39.76281,-94.25848,288.4,978.8,2020-07-13,2020-07-13T12:51:06Z,211
2.21,3.073,34,2.79,165.8,0.301,0.16,330,2.29,214,13.12,7.83,25.05,3.106,39.76281,-94.25848,288.3,978.8,2020-07-13,2020-07-13T12:51:07Z,211
1.92,3.136,29.3,2.43,163.4,0.307,0.16,333.2,1.79,217,11.3,7.78,24.56,3.157,39.76281,-94.25848,288.4,978.9,2020-07-13,2020-07-13T12:51:08Z,211
1.83,3.186,24.5,2.05,159.2,0.312,0.16,338.1,1.51,220,10.24,7.74,24.153,3.216,39.76281,-94.25848,288.4,978.8,2020-07-13,2020-07-13T12:51:09Z,211
1.65,3.247,23.7,2,148.2,0.318,0.16,344.8,1.28,224,9.52,7.69,23.52,3.254,39.7628,-94.25849,288.4,978.9,2020-07-13,2020-07-13T12:51:10Z,211
1.5,3.293,20.9,1.78,142,0.322,0.17,353.3,1.1,230,9.62,7.65,23.022,3.309,39.7628,-94.25849,288.4,978.9,2020-07-13,2020-07-13T12:51:11Z,211
1.49,3.338,18.5,1.58,136.9,0.327,0.17,356.6,1.03,232,10.21,7.62,22.871,3.35,39.7628,-94.25849,288.4,978.8,2020-07-13,2020-07-13T12:51:12Z,211
1.47,3.375,16.3,1.4,134.8,0.33,0.17,359.1,1.02,233,9.95,7.6,22.853,3.39,39.7628,-94.25849,288.4,978.9,2020-07-13,2020-07-13T12:51:13Z,211
1.44,3.413,14.6,1.26,131.9,0.334,0.17,362.2,1,235,9.84,7.59,22.669,3.424,39.7628,-94.25849,288.3,978.9,2020-07-13,2020-07-13T12:51:14Z,211
1.4,3.448,13.2,1.14,127.4,0.337,0.17,366.4,0.98,238,10.14,7.57,22.471,3.471,39.7628,-94.25849,288.4,979,2020-07-13,2020-07-13T12:51:15Z,211
1.4,3.491,12,1.04,123.2,0.342,0.18,370.6,0.98,241,9.68,7.56,22.249,3.497,39.76279,-94.25849,288.4,978.8,2020-07-13,2020-07-13T12:51:16Z,211
1.4,3.528,10.8,0.94,118.7,0.345,0.18,373.8,1.01,243,9.13,7.53,22.092,3.543,39.76279,-94.25849,288.4,978.8,2020-07-13,2020-07-13T12:51:17Z,211
1.34,3.574,9.9,0.87,113.8,0.35,0.18,377.5,0.87,245,9.08,7.5,21.953,3.591,39.76279,-94.25849,288.3,978.9,2020-07-13,2020-07-13T12:51:18Z,211
1.32,3.619,9.1,0.8,109,0.354,0.18,380.3,0.81,247,9.34,7.48,21.805,3.631,39.76279,-94.25849,288.3,978.8,2020-07-13,2020-07-13T12:51:19Z,211
1.33,3.651,8.5,0.75,104.5,0.357,0.18,385.4,0.87,250,9.28,7.47,21.64,3.68,39.76279,-94.25848,288.1,978.8,2020-07-13,2020-07-13T12:51:20Z,211
1.32,3.717,7.8,0.69,99.9,0.364,0.19,392.4,0.89,255,9.16,7.45,21.264,3.737,39.76279,-94.25848,288.1,978.7,2020-07-13,2020-07-13T12:51:21Z,211
1.27,3.765,7.3,0.65,90,0.369,0.19,399.9,0.86,260,9.35,7.43,20.959,3.786,39.76279,-94.25848,288.1,978.8,2020-07-13,2020-07-13T12:51:22Z,211
1.28,3.824,6.8,0.61,85.4,0.374,0.19,405.2,0.78,263,9.12,7.42,20.713,3.838,39.76279,-94.25848,288,978.9,2020-07-13,2020-07-13T12:51:23Z,211
1.28,3.878,6.4,0.57,80.8,0.38,0.2,411.6,0.69,268,8.91,7.41,20.427,3.889,39.76279,-94.25848,287.9,979,2020-07-13,2020-07-13T12:51:24Z,211
1.22,3.913,6,0.54,78.2,0.383,0.2,413.8,0.7,269,8.79,7.4,20.423,3.925,39.76279,-94.25848,287.9,978.8,2020-07-13,2020-07-13T12:51:25Z,211
1.2,3.951,5.7,0.51,75,0.387,0.2,415.4,0.78,270,8.79,7.4,20.41,3.972,39.76279,-94.25849,287.9,978.8,2020-07-13,2020-07-13T12:51:26Z,211
1.18,3.994,5.4,0.48,70.9,0.391,0.2,418.1,0.73,272,8.95,7.39,20.161,4.013,39.76279,-94.25849,287.9,979,2020-07-13,2020-07-13T12:51:27Z,211
1.17,4.049,5.1,0.46,66.7,0.396,0.2,425.7,0.62,277,9.11,7.38,19.705,4.069,39.76279,-94.25849,288,978.8,2020-07-13,2020-07-13T12:51:28Z,211
1.16,4.093,4.8,0.44,62.7,0.401,0.21,433.8,0.56,282,9.16,7.38,19.133,4.109,39.76279,-94.25849,287.7,978.8,2020-07-13,2020-07-13T12:51:29Z,211
1.06,4.138,4.6,0.42,58.3,0.405,0.21,442,0.53,287,8.46,7.37,18.685,4.152,39.76279,-94.25849,287.6,978.9,2020-07-13,2020-07-13T12:51:30Z,211
0.97,4.214,4.2,0.39,49.8,0.413,0.22,450.9,0.5,293,8.52,7.36,18.129,4.244,39.76279,-94.25849,287.8,978.9,2020-07-13,2020-07-13T12:51:32Z,211
0.9,4.286,3.9,0.37,45.6,0.42,0.22,458.6,0.48,298,8.56,7.35,17.494,4.301,39.76279,-94.25849,287.8,978.9,2020-07-13,2020-07-13T12:51:33Z,211
0.93,4.341,3.8,0.36,41.5,0.425,0.22,461.9,0.43,300,8.55,7.35,17.34,4.361,39.76278,-94.25849,287.6,978.9,2020-07-13,2020-07-13T12:51:34Z,211
0.87,4.394,3.6,0.35,37.6,0.43,0.22,464.3,0.42,302,8.27,7.34,17.077,4.418,39.76279,-94.25849,287.7,978.9,2020-07-13,2020-07-13T12:51:35Z,211
0.83,4.455,3.5,0.33,33.6,0.436,0.23,470.3,0.48,306,8.47,7.33,16.574,4.462,39.76278,-94.25849,287.7,979,2020-07-13,2020-07-13T12:51:36Z,211
0.84,4.476,3.3,0.33,29.8,0.439,0.23,472.4,0.51,307,8.69,7.33,16.363,4.484,39.76278,-94.25849,287.8,978.9,2020-07-13,2020-07-13T12:51:37Z,211
0.87,4.51,3.2,0.32,26.2,0.442,0.23,474.2,0.48,308,9.04,7.32,16.205,4.545,39.76278,-94.25849,287.8,978.8,2020-07-13,2020-07-13T12:51:38Z,211
0.9,4.564,3.1,0.31,22.6,0.447,0.23,476.5,0.51,310,8.75,7.32,15.865,4.568,39.76278,-94.25849,287.7,978.9,2020-07-13,2020-07-13T12:51:39Z,211
0.97,4.595,3,0.3,18.8,0.45,0.23,478.8,0.56,311,8.58,7.31,15.551,4.621,39.76278,-94.25849,287.7,978.9,2020-07-13,2020-07-13T12:51:40Z,211
0.98,4.645,2.9,0.29,15,0.455,0.23,481.6,0.57,313,8.81,7.3,15.201,4.665,39.76278,-94.25849,287.6,978.9,2020-07-13,2020-07-13T12:51:41Z,211
0.97,4.697,2.8,0.28,11.2,0.46,0.23,482.6,0.56,314,9.31,7.3,15.082,4.725,39.76278,-94.25849,287.4,978.9,2020-07-13,2020-07-13T12:51:42Z,211
0.97,4.756,2.7,0.27,7.3,0.466,0.23,484,0.6,315,9.52,7.29,14.913,4.779,39.76278,-94.25849,287.4,978.8,2020-07-13,2020-07-13T12:51:43Z,211
0.95,4.812,2.6,0.27,3.5,0.472,0.24,484.9,0.57,315,9.29,7.28,14.761,4.842,39.76278,-94.25849,287.4,978.8,2020-07-13,2020-07-13T12:51:44Z,211
1.01,4.884,2.6,0.26,-0.1,0.479,0.24,485.6,0.47,316,9.06,7.27,14.677,4.898,39.76278,-94.25849,287.3,978.8,2020-07-13,2020-07-13T12:51:45Z,211
0.97,4.923,2.5,0.25,-3.9,0.482,0.24,486,0.45,316,8.87,7.27,14.612,4.939,39.76278,-94.25849,287.2,978.7,2020-07-13,2020-07-13T12:51:46Z,211
0.9,4.958,2.4,0.25,-7.6,0.486,0.24,486.6,0.43,316,8.47,7.26,14.594,4.965,39.76278,-94.25849,287.1,978.9,2020-07-13,2020-07-13T12:51:47Z,211
0.91,4.986,2.4,0.24,-10.9,0.489,0.24,486.9,0.42,316,8.51,7.26,14.561,4.995,39.76278,-94.25849,287.1,978.9,2020-07-13,2020-07-13T12:51:48Z,211
0.91,5.027,2.3,0.23,-14.5,0.493,0.24,487,0.41,317,8.57,7.26,14.488,5.041,39.76278,-94.25849,287.1,978.8,2020-07-13,2020-07-13T12:51:49Z,211
0.9,5.077,2.2,0.23,-17.3,0.498,0.24,487.7,0.39,317,8.47,7.25,14.304,5.114,39.76278,-94.25849,287.2,978.7,2020-07-13,2020-07-13T12:51:50Z,211
0.91,5.156,2.2,0.22,-20.1,0.505,0.24,488.3,0.47,317,8.55,7.25,14.086,5.178,39.76278,-94.25849,287.3,978.8,2020-07-13,2020-07-13T12:51:51Z,211
0.87,5.209,2.1,0.22,-23.1,0.511,0.24,488.7,0.5,318,8.32,7.25,13.995,5.226,39.76278,-94.25849,287.5,978.9,2020-07-13,2020-07-13T12:51:52Z,211
0.88,5.253,2.1,0.21,-25.9,0.515,0.24,489.6,0.45,318,8.1,7.24,13.92,5.274,39.76278,-94.25849,287.5,978.8,2020-07-13,2020-07-13T12:51:53Z,211
0.9,5.313,2,0.21,-28.6,0.521,0.24,490.3,0.46,319,8.02,7.24,13.858,5.326,39.76278,-94.25849,287.6,978.9,2020-07-13,2020-07-13T12:51:54Z,211
0.93,5.347,2,0.21,-31.1,0.524,0.24,490.7,0.51,319,8.1,7.24,13.827,5.375,39.76278,-94.25849,287.4,978.9,2020-07-13,2020-07-13T12:51:55Z,211
0.92,5.417,1.9,0.2,-33.4,0.531,0.24,491.2,0.5,319,8.13,7.24,13.683,5.452,39.76278,-94.25849,287.3,978.9,2020-07-13,2020-07-13T12:51:56Z,211
0.88,5.495,1.9,0.2,-35.6,0.539,0.24,491.7,0.39,320,7.9,7.23,13.602,5.508,39.76278,-94.25849,287,978.9,2020-07-13,2020-07-13T12:51:57Z,211
0.91,5.532,1.9,0.19,-37.9,0.542,0.24,492.4,0.36,320,7.85,7.23,13.508,5.547,39.76278,-94.25848,286.7,978.8,2020-07-13,2020-07-13T12:51:58Z,211
0.92,5.566,1.8,0.19,-40,0.546,0.24,492.7,0.4,320,7.85,7.23,13.472,5.598,39.76279,-94.25848,286.5,978.8,2020-07-13,2020-07-13T12:51:59Z,211
0.93,5.631,1.8,0.18,-41.9,0.552,0.24,492.7,0.41,320,7.99,7.22,13.403,5.649,39.76279,-94.25848,286.3,978.8,2020-07-13,2020-07-13T12:52:00Z,211
0.98,5.677,1.7,0.18,-43.9,0.556,0.24,493.7,0.37,321,8.23,7.22,13.295,5.696,39.76279,-94.25849,286.3,978.9,2020-07-13,2020-07-13T12:52:01Z,211
1,5.742,1.7,0.18,-45.7,0.563,0.24,494.5,0.37,321,7.85,7.21,13.219,5.763,39.76279,-94.25849,286.2,978.9,2020-07-13,2020-07-13T12:52:02Z,211
0.95,5.787,1.6,0.17,-47.5,0.567,0.24,495.8,0.41,322,7.63,7.21,13.113,5.801,39.76279,-94.25849,286,978.9,2020-07-13,2020-07-13T12:52:03Z,211
0.95,5.829,1.6,0.17,-49.2,0.571,0.24,496.7,0.41,323,7.89,7.2,13.045,5.847,39.76279,-94.25849,285.7,978.8,2020-07-13,2020-07-13T12:52:04Z,211
0.96,5.871,1.6,0.16,-50.9,0.575,0.24,497.6,0.45,323,7.85,7.2,12.967,5.898,39.76279,-94.25849,285.8,979,2020-07-13,2020-07-13T12:52:05Z,211
0.93,5.937,1.5,0.16,-52.5,0.582,0.24,499,0.44,324,7.8,7.19,12.85,5.946,39.76279,-94.25849,285.7,978.9,2020-07-13,2020-07-13T12:52:06Z,211
0.92,5.966,1.5,0.16,-54.2,0.585,0.24,499.7,0.47,325,8.07,7.19,12.8,5.987,39.76279,-94.25849,285.8,979,2020-07-13,2020-07-13T12:52:07Z,211
0.94,6.014,1.5,0.15,-55.6,0.59,0.24,500.7,0.47,325,8.2,7.18,12.752,6.032,39.76279,-94.25849,286,978.9,2020-07-13,2020-07-13T12:52:08Z,211
0.95,6.061,1.4,0.15,-57.1,0.594,0.24,501.2,0.42,326,8.1,7.17,12.718,6.073,39.76279,-94.25849,286.1,978.9,2020-07-13,2020-07-13T12:52:09Z,211
1,6.124,1.4,0.15,-59.9,0.6,0.24,501.7,0.48,326,8.06,7.17,12.676,6.136,39.76279,-94.25849,286.5,978.9,2020-07-13,2020-07-13T12:52:11Z,211
0.97,6.161,1.4,0.14,-61.2,0.604,0.24,502.1,0.52,326,8.13,7.16,12.631,6.169,39.76279,-94.25849,286.7,978.8,2020-07-13,2020-07-13T12:52:12Z,211
0.93,6.189,1.3,0.14,-62.3,0.607,0.24,503.2,0.51,327,8.47,7.16,12.521,6.202,39.76279,-94.25849,286.7,978.8,2020-07-13,2020-07-13T12:52:13Z,211
0.94,6.211,1.3,0.14,-63.3,0.609,0.25,504.4,0.49,328,8.58,7.16,12.449,6.225,39.76279,-94.25849,286.6,978.9,2020-07-13,2020-07-13T12:52:14Z,211
1.04,6.266,1.3,0.14,-64.2,0.614,0.25,505.2,0.52,328,8.51,7.15,12.388,6.284,39.76279,-94.25849,286.6,978.8,2020-07-13,2020-07-13T12:52:15Z,211
1.09,6.296,1.2,0.13,-65.4,0.617,0.25,506.1,0.59,329,8.5,7.15,12.333,6.304,39.76279,-94.25849,286.6,978.8,2020-07-13,2020-07-13T12:52:16Z,211
1.1,6.332,1.2,0.13,-66.2,0.621,0.25,506.6,0.58,329,8.34,7.14,12.289,6.348,39.76279,-94.25849,286.5,978.8,2020-07-13,2020-07-13T12:52:17Z,211
1.14,6.38,1.2,0.13,-67.1,0.625,0.25,507.8,0.56,330,8.73,7.14,12.209,6.407,39.76279,-94.25849,286.5,978.7,2020-07-13,2020-07-13T12:52:18Z,211
1.24,6.465,1.2,0.13,-67.9,0.634,0.25,509.3,0.59,331,9.19,7.13,12.097,6.478,39.76279,-94.2585,286.8,979,2020-07-13,2020-07-13T12:52:19Z,211
1.29,6.506,1.2,0.12,-68.8,0.638,0.25,510.5,0.62,332,9.04,7.13,12.063,6.515,39.76279,-94.2585,286.6,978.9,2020-07-13,2020-07-13T12:52:20Z,211
1.34,6.559,1.1,0.12,-69.9,0.643,0.25,511,0.63,332,9.39,7.12,12.046,6.589,39.76279,-94.25849,286.5,979,2020-07-13,2020-07-13T12:52:21Z,211
1.62,6.637,1.1,0.12,-70.6,0.651,0.25,512.4,0.8,333,9.99,7.12,11.974,6.661,39.76279,-94.25849,286.6,978.8,2020-07-13,2020-07-13T12:52:22Z,211
2.38,6.698,1.1,0.11,-71.5,0.657,0.25,513.1,1.31,334,50.76,7.11,11.949,6.703,39.76279,-94.25849,286.6,978.8,2020-07-13,2020-07-13T12:52:23Z,211
2.7,6.719,1.1,0.11,-72.3,0.659,0.25,513.6,1.6,334,47.96,7.11,11.947,6.725,39.76279,-94.25849,286.6,978.8,2020-07-13,2020-07-13T12:52:24Z,211
